1,1,1,1,1,1,1,1,1,1,1,1,1,1,1,1,1,1,1,1
1,_,_,_,_,_,_,_,_,_,_,_,_,_,_,_,_,_,_,1
1,_,_,_,_,_,_,_,_,_,_,_,_,_,_,_,_,_,1,1
1,_,_,_,_,_,2,_,_,_,_,2,_,_,_,_,_,_,_,1
1,_,_,_,_,_,_,_,_,_,_,_,_,_,_,_,_,2,_,1
1,_,_,_,_,1,_,_,_,_,_,_,_,_,_,_,_,_,_,1
1,_,_,_,_,_,_,_,_,_,_,_,_,_,_,_,_,_,_,1
1,_,_,_,_,_,_,_,_,_,_,_,_,_,_,_,_,_,_,1
1,_,_,_,_,_,_,_,_,_,_,_,_,_,_,_,_,_,_,1
1,_,_,1,_,_,_,_,_,_,_,_,_,_,_,_,1,_,_,1
1,_,_,_,_,_,_,_,_,_,_,_,_,_,_,_,_,_,_,1
1,_,_,_,_,_,_,_,_,_,_,_,_,_,_,_,_,2,_,1
1,_,_,_,_,_,_,_,_,_,_,_,_,_,_,_,_,_,_,1
1,_,_,_,_,_,_,_,_,_,_,_,_,_,_,_,_,_,_,1
1,_,_,_,_,_,_,_,_,_,_,_,_,_,_,_,_,_,_,1
1,_,_,_,_,_,_,_,_,_,_,_,_,_,_,_,2,_,_,1
1,_,_,_,_,_,_,_,_,_,_,_,_,_,_,_,_,_,_,1
1,_,_,_,_,_,_,_,_,_,_,_,_,2,_,_,_,_,_,1
1,_,_,_,_,_,_,_,_,_,_,_,_,_,_,_,_,_,_,1
1,1,1,1,1,1,1,1,1,1,1,1,1,1,1,1,1,1,1,1
